0000000000000000000000000000000000000000
0000000000000000000000000000000000000000
0000000000000000000000000000000000000000
1111111111111111111111111111111111111111
1111111111111111111111111111111111111111
1110000000000011100000000000000000000111
1110000000000011100000000000000000000111
1110000000000011111111110011111000000111
1110000000000011111111110011111000000111
1110000000000011100000000000000000000111
0000000000000000000000000000000000000111
0200000000000000000000000000000000000111
1111111111111111111111111111111111100111
1111111111111111111111111111111111100111
1111111111111111111111111111111111100111
1110000000000000011111000000000000000111
1110000000000000011111000000000000000111
1110000000000000011111000000000000000111
1110000000000000000000000000000000000111
1110000000000000000000000000000000000111
1110011111111111111111111111111111111111
1110011111111111111111111111111111111111
1110011111111111111111111111111111111111
