0000000000000000000000000000000000000000
0000000000000000000000000000000000000000
0000000000000000000000000000000000000000
0000000000000000000000000000000000000000
1111111111111111111111111111111111111111
1111111111111111111111111111111111111111
1110000000000011150000000000000000000111
1110000000000011111111110011111000000111
1110000400000011111111110011111000000111
1110000000000011111111110011111000000111
1110000000000011100000000000000000000111
2000000000000000000000000000000000000111
1111111111111111111111111111111111100111
1111111111111111111111111111111111100111
1111111111111111111111111111111111100111
1111111111111111111111111111111111100111
1110000000000000011111000000000000000111
1110000000000000011111000060000000000111
1110000000000000011111000000000000000111
1110000007000000000000000000000000000111
1110311111111111111111111111111111111111
1110011111111111111111111111111111111111
1110011111111111111111111111111111111111