0000000000000000000000000000000000000000
0000000000000000000000000000000000000000
0000000000000000000000000000000000000000
0000000000000000000000000000000000000000
1111111111111111111111111111111111111111
1111111111111111111111111111111111111111
1111111111111111111111110000000000400001
1100000000000001100000110000000000000001
1100050000000001100000110000000000110001
1100000000000000000000000000000000110002
1100011111111111100000110000001111111111
1100011111111111100000110000001111111111
1100011111111111111111111111111111111111
1100000000000001111111111111111100000001
1100000000000001111111111111111100000001
1100000001100000000000110000001100000001
1100000001100000000000110070001100000001
1100060001100000000000000000001100000001
1100000001100000000000110000000000000001
1100000001100000000000110000000000000001
1111111111111111111111111111111111111031
1111111111111111111111111111111111111001
1111111111111111111111111111111111111001